###################
#.................#
>>>>v.............#
#...v.............#
#...v......www....#
#...v.....wwww....#
#.v<<.....ww......#
#.v.......wwww....#
#.v.........ww....#
#.v.....wwwww.....#
#.v...wwwww.......#
#.v.wwwww.........#
#.v..www...>>>>v..#
#.v..www...^...v..#
#.v...www..^...v..#
#.v...wwww.^...v..#
#.v........^...v..#
#.v>>>>>>>>^...>>>>
#.................#
###################