###################
#...>>>>>>>>>>>v..#
#...^.w.w.w.w..v..#
#...^<<<<<<<<..v..#
#...........^..v..#
#...wwwww...^..v..#
#..www......^..v..#
#.www..>>>>>^..v..#
#..ww..^.......v..#
#...w..^..v<<<<<..#
#...w..^..v.......#
#...w..^..v.......#
#..ww..^..>>>>>v..#
#..ww..^.......v..#
#......^.......v..#
>>>>>v.^<<<<<..v..#
#....v......^..>>>>
#....v......^.....#
#....>>>>>>>^.....#
###################