###################
#.................#
#.>>>>>>>>>>>>v...#
#.^...........v...#
#.^..ww...ww..v...#
#.^..ww...ww..v...#
#.^...........v...#
#.^.v<<...v<<<<...#
#.^.v.^...v.......#
#.^.v.^...v..w.>>>>
#.^.v.^...v.ww.^..#
#.^.v.^...v.ww.^..#
#.^.v.^...v.ww.^..#
#.^.v.^...v.ww.^..#
#.^.v.^...v....^..#
#.^.v.^...>>>>>^..#
#.^.v.^...........#
#.^<<.^...wwwwww..#
#.....^..ww..www..#
######^############