#########v#########
#..ww....v........#
#...w....v......ww#
#...ww...v.....ww.#
#...ww...v.....ww.#
#...ww...v.....ww.#
#...ww...v.....ww.#
#...ww...v.....ww.#
#...ww...v...wwww.#
#....ww..v...w....#
#.....w..v...w....#
#...www..v...w....#
#..ww.w..v...w....#
#..wwww..v...www..#
#.....w..v........#
#.....w..v........#
#....ww..v........#
#....ww..v........#
#........v........#
#########v#########