###################
#.................#
#......wwwwwwww...#
#...wwwwwwww......#
#.................#
>>>>>>>v...>>>>v..#
#......v...^...v..#
#......v...^...v..#
#......v...^...v..#
#......>>>>^...v..#
#..............v..#
#......v<<<<...v..#
#......v...^...v..#
#......v...^...v..#
<<<<<<<<...^<<<<..#
#.................#
#...wwwwwwww......#
#......wwwwwwww...#
#.................#
###################