###################
#..>>>>>>>>>>>>v..#
#..^...........v..#
#..^<<<<...v<<<<..#
#......^...v......#
#....w.^...v...ww.#
#...ww.^...v...ww.#
#..wwww^...v...ww.#
#..www.^...v..ww..#
#..www.^...v..ww..#
#...ww.^...v..www.#
#...ww.^...v...ww.#
#...ww.^...v....w.#
#...ww.^...v..www.#
#..wwww^...v..w.w.#
#...www^...v..ww..#
#....ww^...v..ww..#
#.....w^...v..ww..#
#......^...v......#
#######^###v#######