###################
#.................#
>>>>>>>v....ww....#
#......v....www...#
#......v...wwwww..#
#..ww..v..wwwwww..#
#..ww..v..wwwww...#
#..ww..v..........#
#...ww.v.>>>>>>>>>>
#...ww.v.^........#
#.www..v.^.v<<<<..#
#.www..v.^.v...^..#
#..w...v.^.v...^..#
#..w...v.^.v...^..#
#..ww..v.^.v...^..#
#..ww..v.^<<...^..#
#...w..v.......^..#
#......>>>>>>>>^..#
#.................#
###################