###################
#...www..ww.......#
#.....wwwwwwww....#
#.................#
#...v<<<<<<<<<<<<<<
#...v.............#
#...>v...wwwwwwww.#
#....v...www....w.#
#....>v..wwww.....#
#.....v.....ww....#
#.....>v....www...#
#......v.....ww...#
#..ww..>v.....ww..#
#...w...v.....ww..#
#..ww...>v....ww..#
#..ww....v....www.#
#...ww...>v....ww.#
#...www...v....ww.#
#.....w...>v......#
###########v#######