###################
#.................#
#.................#
#.................#
#............>>>>>>
#.......www..^....#
#wwwwwwwwww..^....#
#....wwwwww..^....#
#............^....#
>>>>>>>v.....^....#
#......v.....^....#
#......v.....^....#
#......v>>>>>^....#
#.................#
#.................#
#.ww....www.......#
#wwww...w.wwwwww..#
#...wwwww..wwwwwww#
#.................#
###################